type octile
height 8
width 10
map
..........
.@@@@@@@@.
..........
.@@@@@@@@.
..........
.@@@@@@@@.
..........
..........