type octile
height 3
width 8
map
........
........
........
