type octile
height 3
width 9
map
.........
....@....
.........