type octile
height 11
width 37
map
@@@.@@@@.@@@@.@@@@.@@@@.@@@@.@@@@.@@@
.....................................
@@@.@@@@.@@@@.@@@@.@@@@.@@@@.@@@@.@@@
@@@.@@@@.@@@@.@@@@.@@@@.@@@@.@@@@.@@@
@@@.@@@@.@@@@.@@@@.@@@@.@@@@.@@@@.@@@
.....................................
@@@.@@@@.@@@@.@@@@.@@@@.@@@@.@@@@.@@@
@@@.@@@@.@@@@.@@@@.@@@@.@@@@.@@@@.@@@
@@@.@@@@.@@@@.@@@@.@@@@.@@@@.@@@@.@@@
.....................................
@@@.@@@@.@@@@.@@@@.@@@@.@@@@.@@@@.@@@
